**************
*****g********
***** ********
*****b bg*****
***g bh*******
******b*******
******g*******
**************
**************
