 **********        
 * h      *********
 *    bb  *       *
 *      b *       *
 *        *    g  *
 *        *    g  *
 *                *
 *                *
 **********    g***
          *******  
