************
*gg  *     ***
*gg  * b  b  *
*gg  *b****  *
*gg    h **  *
*gg  * *  b **
****** **b b *
  * b  b b b *
  *    *     *
  ************
