 *****  
 * h ***
** *b  *
* bg g *
*  bb **
*** *g* 
  *   * 
  ***** 
